Das Oktoberfest ist ein interessantes Brauchtum	Oktoberfest is an interesting tradition
Oktoberfest is an interesting tradition	Das Oktoberfest ist ein interessantes Brauchtum
Die Kinder freuen sich über das Büchlein mit der gelben Katze	The children are happy about the booklet with the yellow cat
The children are happy about the booklet with the yellow cat	Die Kinder freuen sich über das Büchlein mit der gelben Katze
Ich habe dir ein leckeres Süppchen gekocht	I made you a delicious (little) soup
I made you a delicious (little) soup	Ich habe dir ein leckeres Süppchen gekocht
Mein Monitor ist kaputt	My monitor is broken
My monitor is broken	Mein Monitor ist kaputt
Du kannst als Redakteurin bei einer Zeitung arbeiten	You can work as an editor at a newspaper
You can work as an editor at a newspaper	Du kannst als Redakteurin bei einer Zeitung arbeiten
Der Schmetterling ist bunt	The butterfly is colorful
The butterfly is colorful	Der Schmetterling ist bunt
Der Anwalt hat viele Akten	The lawyer has a lot of files
The lawyer has a lot of files	Der Anwalt hat viele Akten
In der Konditorei kaufen wir Kuchen	In the pastry shop we buy cakes
In the pastry shop we buy cakes	In der Konditorei kaufen wir Kuchen
In der Manufaktur arbeiten viele Menschen	In the factory many people work
In the factory many people work	In der Manufaktur arbeiten viele Menschen
Die Polizei war schnell vor Ort	The police were quickly on site
The police were quickly on site	Die Polizei war schnell vor Ort
Die Realität ist manchmal hart	The reality is sometimes harsh
The reality is sometimes harsh	Die Realität ist manchmal hart
Deutschland ist eine Republik	Germany is a republic
Germany is a republic	Deutschland ist eine Republik
Endungen für Nomen im Femininum -> ?	-heit, -keit, -ung, -schaft, -in also -ei, -e, -ität, -ik, -ur, -ion
-heit, -keit, -ung, -schaft, -in also -ei, -e, -ität, -ik, -ur, -ion	Endungen für Nomen im Femininum -> ?
Endungen für Nomen im Maskulinum -> ?	-er, -or, -eur, -ismus, -ling
-er, -or, -eur, -ismus, -ling	Endungen für Nomen im Maskulinum -> ?
Endungen für Nomen im Neutrum -> ?	-chen, -lein, -ment, -um, -tum
-chen, -lein, -ment, -um, -tum	Endungen für Nomen im Neutrum -> ?
Ich kann typische Genusendungen erkennen und bilden	I can recognize and build typical gender endings
I can recognize and build typical gender endings	Ich kann typische Genusendungen erkennen und bilden
die Mannschaft	the team
the team	die Mannschaft
die Krankheit, die Dunkelheit	the illness, the darkness
the illness, the darkness	die Krankheit, die Dunkelheit
die Helligkeit, die Einsamkeit	the brightness, the loneliness
the brightness, the loneliness	die Helligkeit, die Einsamkeit
die Lampe, die Musik, die Kultur, die Religion	the lamp, the music, the culture, the religion
the lamp, the music, the culture, the religion	die Lampe, die Musik, die Kultur, die Religion
Manche Endungen bei Nomen zeigen das Genus an	Some endings in nouns indicate the gender
Some endings in nouns indicate the gender	Manche Endungen bei Nomen zeigen das Genus an
der Direktor, der Autor	the director, the author
the director, the author	der Direktor, der Autor
der Redakteur, der Ingenieur	the editor, the engineer
the editor, the engineer	der Redakteur, der Ingenieur
der Pessimismus, der Optimismus, der Idealismus	the pessimism, the optimism, the idealism
the pessimism, the optimism, the idealism	der Pessimismus, der Optimismus, der Idealismus
der Zwilling, der Liebling	the twin, the darling
the twin, the darling	der Zwilling, der Liebling
das Mädchen, das Männchen	the girl, the boy
the girl, the boy	das Mädchen, das Männchen
das Männlein, das Tischlein	the little man, the little table
the little man, the little table	das Männlein, das Tischlein
das Parlament, das Dokument	the parliament, the document
the parliament, the document	das Parlament, das Dokument
das Datum, das Studium	the date, the studies (education)
the date, the studies (education)	das Datum, das Studium
das Eigentum, das Besitztum	the property, the possession
the property, the possession	das Eigentum, das Besitztum
das Erlebnis	the experience
the experience	das Erlebnis
das Ergebnis	the result
the result	das Ergebnis
Cool, aber Kunst ist leider nicht mein Ding	Cool, but unfortunately art isn't my thing
Cool, but unfortunately art isn't my thing	Cool, aber Kunst ist leider nicht mein Ding
Hast du eine andere Option?	Do you have another option?
Do you have another option?	Hast du eine andere Option?
Wie wär’s mit dem DDR-Museum in Mitte?	How about the DDR-Museum in Mitte?
How about the DDR-Museum in Mitte?	Wie wär’s mit dem DDR-Museum in Mitte?
Oh ja, da wollte ich schon immer mal hin	Oh yes, I've always wanted to go there
Oh yes, I've always wanted to go there	Oh ja, da wollte ich schon immer mal hin
Das wird bestimmt ein besonderes Erlebnis	This will definitely be a special experience
This will definitely be a special experience	Das wird bestimmt ein besonderes Erlebnis
Echt? Kunst ist genau mein Ding	Real? Art is exactly my thing
Real? Art is exactly my thing	Echt? Kunst ist genau mein Ding
Erzähle von einer besonderen Freundschaft	Tell about a special friendship
Tell about a special friendship	Erzähle von einer besonderen Freundschaft
Was ist dein Lieblingsmuseum? Warum?	What is your favorite museum? Why?
What is your favorite museum? Why?	Was ist dein Lieblingsmuseum? Warum?
Beschreibe deine Nachbarschaft	Describe your neighborhood
Describe your neighborhood	Beschreibe deine Nachbarschaft
Erfinde eine Geschichte	Make up a story
Make up a story	Erfinde eine Geschichte
Benutze die Wörter und erzähle, was Louise auf dem Konzert erlebt	Use the words and tell what Louise experiences at the concert
Use the words and tell what Louise experiences at the concert	Benutze die Wörter und erzähle, was Louise auf dem Konzert erlebt
Redewendung: "Was Hänschen nicht lernt, lernt Hans nimmer mehr." Bedeutung: Wenn man jung ist, lernt man besser	Saying: "What Hans doesn't learn, Hans will never learn anymore." Meaning: When one is young, one learns better
Saying: "What Hans doesn't learn, Hans will never learn anymore." Meaning: When one is young, one learns better	Redewendung: "Was Hänschen nicht lernt, lernt Hans nimmer mehr." Bedeutung: Wenn man jung ist, lernt man besser
Ich konnte schon als Kind kein Instrument spielen. Jetzt habe ich Gitarre versucht, aber es funktioniert einfach nicht. Es stimmt: Was Hänschen nicht lernt, lernt Hans nimmer mehr	I couldn't play an instrument already as a child. Now I tried guitar but it simply doesn't work. It's true: "What Hans doesn't learn, Hans will never learn anymore"
I couldn't play an instrument already as a child. Now I tried guitar but it simply doesn't work. It's true: "What Hans doesn't learn, Hans will never learn anymore"	Ich konnte schon als Kind kein Instrument spielen. Jetzt habe ich Gitarre versucht, aber es funktioniert einfach nicht. Es stimmt: Was Hänschen nicht lernt, lernt Hans nimmer mehr
Suche dir ein Bild aus und beschreibe es	Pick out a picture and describe it
Pick out a picture and describe it	Suche dir ein Bild aus und beschreibe es
Versuche dabei, so viele Wörter mit Genusendungen wie möglich zu benutzen	Try to use as many words with gender endings as possible
Try to use as many words with gender endings as possible	Versuche dabei, so viele Wörter mit Genusendungen wie möglich zu benutzen
Achte auf den korrekten Artikel	Watch out for the correct article
Watch out for the correct article	Achte auf den korrekten Artikel
Die anderen Personen im Kurs müssen erraten, welches Bild du meinst	The other people in the class have to guess which picture you mean
The other people in the class have to guess which picture you mean	Die anderen Personen im Kurs müssen erraten, welches Bild du meinst
Es heißt: die Gelegenheit	It's called: the opportunity
It's called: the opportunity	Es heißt: die Gelegenheit
das Abonnement	subscription
subscription	das Abonnement
der Kollege, der Kunde, der Junge, der Löwe	the colleague, the customer, the boy, the lion
the colleague, the customer, the boy, the lion	der Kollege, der Kunde, der Junge, der Löwe
Nomen der N-Deklination sind maskulin (der) und enden im Akkusativ und Dativ auf -(e)n. Ich kenne den Nachbarn. Ich spreche mit dem Studenten. Ich lade den Kunden ein	Nouns with the N declension are masculine (der) and end in -(e)n in the accusative and dative cases. I know the neighbor. I'm talking to the student. I invite the customer
Nouns with the N declension are masculine (der) and end in -(e)n in the accusative and dative cases. I know the neighbor. I'm talking to the student. I invite the customer	Nomen der N-Deklination sind maskulin (der) und enden im Akkusativ und Dativ auf -(e)n. Ich kenne den Nachbarn. Ich spreche mit dem Studenten. Ich lade den Kunden ein
Bei Nomen der N-Deklination ist außer im Nominativ Singular die Endung immer –(e)n	For nouns with the N declension, the ending is always -(e)n, except in the nominative singular
For nouns with the N declension, the ending is always -(e)n, except in the nominative singular	Bei Nomen der N-Deklination ist außer im Nominativ Singular die Endung immer –(e)n
Ein grünes T-shirt	A green T-shirt
A green T-shirt	Ein grünes T-shirt
Eine rote Mütze und ein roter Schal	A red hat and a red scarf
A red hat and a red scarf	Eine rote Mütze und ein roter Schal
Eine dunkle Hose, ein weißes Hemd und ein schwarzer Gürtel	A dark pants, a white shirt and a black belt
A dark pants, a white shirt and a black belt	Eine dunkle Hose, ein weißes Hemd und ein schwarzer Gürtel
Rote Socken	Red socks
Red socks	Rote Socken
Blaue Schuhe	Blue shoes
Blue shoes	Blaue Schuhe
Eine weiße Bluse	A white blouse
A white blouse	Eine weiße Bluse
Da ist ein graues Kostüm	Here is a gray costume
Here is a gray costume	Da ist ein graues Kostüm
Sie trägt eine schicke Jacke	She is wearing a stylish jacket
She is wearing a stylish jacket	Sie trägt eine schicke Jacke
Er trägt einen schwarzen Anzug mit einer blauen Krawatte	He wears a black suit with a blue tie
He wears a black suit with a blue tie	Er trägt einen schwarzen Anzug mit einer blauen Krawatte
Dann kann ich an heißen Tagen im eigenen Pool schwimmen	Then I can on hot days swim in my own pool
Then I can on hot days swim in my own pool	Dann kann ich an heißen Tagen im eigenen Pool schwimmen
Ich möchte im Garten auch einen schönen Pool bauen lassen	I would also like to have a nice pool built in the garden
I would also like to have a nice pool built in the garden	Ich möchte im Garten auch einen schönen Pool bauen lassen
Welches Genus hat die Endung -ung?	What gender has the ending "-ung"?
What gender has the ending "-ung"?	Welches Genus hat die Endung -ung?
Welches Genus hat die Endung -nis?	What gender has the ending "-nis"?
What gender has the ending "-nis"?	Welches Genus hat die Endung -nis?
Ich habe viele neue Nachbarn	I have many new neighbors
I have many new neighbors	Ich habe viele neue Nachbarn
Max fährt ein rotes Auto	Max drives a red car
Max drives a red car	Max fährt ein rotes Auto
